Teleporter
20
6
11
111000---00000100000
0010001-100000100000
001000---00111111100
001000---00111111100
001000---00111111100
001000---00111111100
001000---00001-10000
00111111111111110000
001----------1110000
--1----------1-10000
--11--11100011110000
--111-11111111110000
--11--111---1--10000
--11--------11110000
--11-0-0----1-------
--11------1111------
00111111111111000000
00111111111111000000
00000000001111000000
00000000000000000000