Cyberbeast
20
2
2
000000000000000-----
01111--111110-------
0111111111110-------
01111--111110-------
01111----1--0-------
001------1--0-------
--1----111110-------
--1----111110-------
--11111111110-1-----
--1010011111111-----
-111110111110-1-----
-101010001000-------
-111110111110-------
-110110111110-------
-111110111110-------
-111110001000-------
---1----------------
--------------------
--------------------
--------------------
--------------------