Alien King
20
4
1
00000000000000000000
----1------1111-----
---1111----1111-----
---111111111111-----
---1111-00-1111-----
---10000000011------
---1---1----100-----
111111111111110-----
-1----------100-----
-1----------11111111
111-------001100----
111------00111100---
111----001111111100-
-1-----001111111100-
-111111111111111110-
-------000100001000-
----0000001111110---
----0111001111110---
----0111111111110---
----0111001111110---
----0000000000000---