TEST
20
10
10
11111111111111111111
-111111111111111111-
-111111111111111111-
-111-11--11--11-111-
-11--11--11--11--11-
-11--11--11--11--11-
-111111111111111111-
-11--11--11--11--11-
-11--1111111111--11-
-11--1111111111--11-
-11--1111111111--11-
-11--1111111111--11-
-11--11--11--11--11-
-111111111111111111-
-11--11--11--11--11-
-11--11--11--11--11-
-111-11--11--11-111-
-111111111111111111-
-111111111111111111-
11111111111111111111